border_size=1
usage=map

Md          , Hd          , Dd          , Dd          , Rd          , Dd          , Dd          , Dd          , Rd          , Dd          , Rd          , Rd          , Dd          , Dd          , Dd          , Gs          , Gs          , Mm          , Mm          , Mm          , Mm          , Mm^Xm       , Mm^Xm       , Mm^Xm       , Mm^Xm       , Mm^Xm       , Mm^Xm       , Mm^Xm       , Mm^Xm       , Xu          , Xu          , Xu          , Xu          , Xu          , Xu          , Xu          , Xu          , Xu          , Xu          , Xu          , Xu          , Xu          , Xu          , Xu          , Xu          , Xu          
Md          , Hd          , Dd          , Dd          , Dd          , Rd          , Rd          , Rd          , Rd          , Rd          , Rd          , Rd          , Dd          , Dd          , Dd          , Dd          , Dd          , Gs          , Gs          , Gs          , Gs          , Mm          , Mm          , Mm^Xm       , Mm^Xm       , Mm^Xm       , Mm^Xm       , Mm^Xm       , Mm^Xm       , Xu          , Xu          , Xu          , _s          , _s          , _s          , Xu          , _s          , _s          , _s          , Xu          , _s          , _s          , _s          , Xu          , Xu          , Xu          
Md          , Hd          , Dd          , Dd          , Dd          , Rd          , Rd          , Rd          , Rd          , Rd          , Rd          , Rd          , Rd          , Dd          , Dd          , Dd          , Dd          , Dd          , Dd          , Dd          , Dd          , Gs          , Gs          , Mm          , Mm          , Mm          , Mm          , Mm          , Mm          , Mm          , Xu          , Xu          , _s          , _s          , _s          , _s          , _s          , _s          , _s          , _s          , _s          , _s          , _s          , _s          , Xu          , Xu          
Md          , Hd          , Dd          , Dd          , Dd          , Dd          , Rd          , Rd          , Chr         , Chr         , Chr         , Rd          , Chr         , Dd          , Dd          , Dd^Vdt      , Dd          , Dd          , Dd          , Dd          , Dd          , Dd          , Dd          , Gs          , Gs          , Gs          , Gs          , Mm          , Gs          , Mm          , Xu          , Xu          , Xu          , _s          , _s          , _s          , _s          , _s          , _s          , _s          , _s          , _s          , _s          , Xu          , Xu          , Xu          
Md          , Hd          , Hd          , Dd          , Dd          , Dd^Vdt      , Rd          , Rd          , Chr         , 2 Khr       , Chr         , Rd          , Rd          , Dd          , Dd          , Dd          , Hd          , Dd          , Hd          , Dd          , Hd          , Dd          , Dd          , Dd          , Dd          , Dd          , Dd          , Gs          , Dd          , Gs          , Gs          , Xu          , Xu          , Xu          , _s          , _s          , _s          , _s          , _s          , _s          , _s          , _s          , _s          , Xu          , Xu          , Xu          
Md          , Md          , Hd          , Dd          , Dd          , Dd          , Rd          , Rd          , Rd          , Chr         , Rd          , Rd          , Rd          , Dd          , Dd          , Hd          , Hd          , Hd          , Dd          , Hd          , Dd          , Dd          , Re          , Dd          , Dd          , Dd          , Dd          , Dd          , Dd          , Dd          , Dd          , Gs          , Xu          , Xu          , Xu          , _s          , _s          , _s          , _s          , _s          , _s          , _s          , _s          , _s          , Xu          , Xu          
Md          , Md          , Hd          , Dd          , Dd          , Rd          , Rd          , Chr         , Rd          , Rd          , Dd          , Rd          , Rd          , Rd          , Rd          , Dd^Vdt      , Hd          , Dd          , Dd          , Dd          , Dd          , Re          , Re          , Re          , Dd          , Hd          , Hd          , Hd          , Hd          , Dd          , Rd          , Rd          , Dd          , Xu          , Xu          , _s          , _s          , _s          , _s          , _s          , _s          , _s          , _s          , _s          , Xu          , Xu          
Md          , Md          , Hd          , Dd          , Dd          , Dd          , Dd          , Rd          , Dd          , Dd          , Dd^Vdt      , Dd          , Dd          , Rd          , Rd          , Rd          , Rd          , Dd^Dc       , Dd          , Dd^Vdt      , Dd          , Dd          , Dd          , Dd          , Rd          , Dd          , Dd          , Hd          , Rd          , Rd          , Hd          , Dd          , Dd          , Xu          , Xu          , _s          , _s          , _s          , _s          , _s          , _s          , _s          , _s          , _s          , Xu          , Xu          
Md          , Md          , Hd          , Dd          , Dd^Vdt      , Dd          , Dd          , Dd          , Dd          , Dd          , Re          , Dd          , Hd          , Rd          , Rd          , Rd          , Rd          , Rd          , Dd          , Dd          , Dd          , Dd          , Dd          , Rd          , Dd^Dr       , Rd          , Rd          , Rd          , Hd          , Hd          , Hd          , Dd          , Dd          , Dd          , Dd          , Dd          , Xu          , Xu          , Xu          , _s          , Xu          , _s          , _s          , _s          , Xu          , Xu          
Md          , Md          , Md          , Hd          , Dd          , Dd          , Rd          , Rd          , Rd          , Dd          , Hd          , Hd          , Rd          , Rd          , Dd          , Dd          , Rd          , Rd          , Rd          , Dd          , Dd          , Dd          , Rd          , Rd          , Dd          , Dd          , Rd          , Dd          , Dd          , Re          , Dd^Do       , Dd          , Dd          , Dd          , Dd          , Dd          , Dd          , Xu          , Xu          , Xu          , Xu          , Xu          , Xu          , Xu          , Xu          , Xu          
Md^Xm       , Md          , Md          , Hd          , Hd          , Dd          , Dd          , Dd          , Dd          , Rd          , Rd          , Rd          , Dd          , Dd          , Dd          , Dd^Vdt      , Rd          , Rd          , Hd          , Rd          , Rd          , Rd          , Dd          , Dd          , Dd          , Dd          , Rd          , Dd          , Dd          , Dd          , Hd          , Dd          , Dd          , Dd          , Dd          , Dd          , Dd          , Dd          , Gs          , Xu          , Mm          , Xu          , Xu          , Xu          , Xu          , Xu          
Md^Xm       , Md^Xm       , Md          , Md          , Md          , Hd          , Hd          , Dd          , Dd          , Dd          , Dd          , Dd          , Dd          , Dd          , Rd          , Rd          , Rd          , Rd          , Hd          , Hd          , Hd          , Hd          , Dd          , Dd^Dc       , Dd          , Dd          , Rd          , Dd          , Dd          , Dd          , Dd          , Dd          , Dd          , Dd          , Dd          , Dd          , Dd          , Dd          , Gs          , Gs          , Gs          , Mm          , Mm^Xm       , Mm^Xm       , Mm^Xm       , Mm^Xm       
Md^Xm       , Md^Xm       , Md          , Md          , Md          , Hd          , Hd          , Hd          , Hd          , Dd          , Dd^Dc       , Dd          , Dd          , Rd          , Rd          , Rd          , Dd          , Dd          , Dd          , Dd          , Dd          , Dd          , Dd          , Dd          , Rd          , Rd          , Rd          , Dd^Vdt      , Dd          , Dd          , Dd          , Dd^Dc       , Dd          , Dd          , Dd          , Dd          , Dd          , Dd          , Dd          , Gs          , Gs          , Mm          , Mm^Xm       , Mm^Xm       , Mm^Xm       , Mm^Xm       
Md^Xm       , Md^Xm       , Md          , Md          , Hd          , Hd          , Hd          , Hd          , Dd          , Dd          , Dd          , Dd          , Rd          , Rd          , Rd          , Dd          , Dd          , Dd          , Dd          , Dd          , Dd          , Dd          , Rd          , Rd          , Rd          , Dd          , Dd          , Rd          , Rd          , Dd          , Dd          , Dd          , Dd          , Hd          , Dd          , Dd          , Dd          , Dd          , Dd          , Gs          , Gs          , Mm          , Mm          , Mm^Xm       , Mm^Xm       , Mm^Xm       
Md^Xm       , Md^Xm       , Md          , Md          , Hd          , Hd          , Dd          , Dd          , Dd          , Dd          , Rd          , Rd          , Dd^Dr       , Rd          , Rd          , Rd          , Rd          , Dd^Vdt      , Rd          , Rd          , Rd          , Rd          , Dd^Dr       , Dd          , Rd          , Dd          , Dd          , Dd          , Dd          , Rd          , Rd          , Dd          , Hd          , Hd          , Dd          , Dd          , Dd          , Dd          , Dd          , Gs          , Gs          , Mm^Vhh      , Mm          , Mm^Xm       , Mm^Xm       , Mm^Xm       
Md^Xm       , Md^Xm       , Md^Xm       , Md          , Hd          , Dd          , Dd          , Dd          , Dd^Vdt      , Rd          , Dd          , Dd          , Dd          , Rd          , Rd          , Rd          , Rd          , Rd          , Rd          , Rd          , Rd          , Rd          , Rd          , Dd          , Rd          , Dd          , Dd          , Dd          , Dd          , Dd          , Dd          , Rd          , Rd          , Rd          , Rd          , Dd          , Dd          , Dd          , Dd          , Gs          , Gs          , Gs          , Mm          , Mm^Xm       , Mm^Xm       , Mm^Xm       
Md^Xm       , Md^Xm       , Md^Xm       , Md          , Hd          , Dd          , Rd          , Rd          , Rd          , Rd          , Dd          , Dd          , Rd          , Rd          , Dd          , Dd          , Dd          , Dd          , Dd          , Dd          , Dd          , Rd          , Rd          , Rd          , Rd          , Dd          , Dd          , Dd          , Dd          , Dd          , Hd          , Hd          , Dd          , Dd^Vda      , Dd          , Rd          , Rd          , Rd          , Rd          , Dd          , Gs          , Gs          , Gs          , Mm          , Mm^Xm       , Mm^Xm       
Md^Xm       , Md^Xm       , Md          , Md          , Rd          , Rd          , Dd          , Dd          , Dd          , Dd          , Rd          , Rd          , Dd          , Dd          , Dd          , Dd          , Hd          , Dd          , Hd          , Hd          , Hd          , Dd          , Dd          , Rd          , Rd          , Dd          , Dd          , Dd          , Hd          , Hd          , Re          , Hd          , Re          , Dd          , Dd          , Dd          , Dd          , Dd          , Dd          , Rd          , Gs          , Gs          , Gs          , Mm          , Mm^Xm       , Mm^Xm       
Md          , Md          , Rd          , Rd          , Hd          , Dd          , Dd          , Dd          , Dd          , Dd          , Rd          , Dd          , Dd          , Dd          , Hd          , Hd          , Dd^Do       , Hd          , Hd          , Hd          , Dd          , Dd          , Rd          , Rd          , Dd^Vdt      , Dd          , Dd          , Dd          , Dd          , Re          , Dd          , Re          , Dd          , Dd          , Dd          , Dd          , Dd          , Dd          , Dd          , Dd          , Gs          , Gs          , Gs          , Mm^Vhh      , Mm^Xm       , Mm^Xm       
Rd          , Rd          , Md          , Md          , Hd          , Dd          , Dd          , Dd          , Dd          , Dd          , Rd          , Dd          , Dd          , Dd          , Hd          , Hd          , Hd          , Hd          , Dd          , Dd          , Rd          , Rd          , Rd          , Rd          , Dd          , Dd          , Dd          , Dd          , Dd          , Dd          , Dd          , Hd          , Hd          , Dd^Vda      , Dd          , Dd          , Dd          , Dd          , Dd          , Dd          , Gs          , Gs          , Gs          , Mm          , Mm^Xm       , Mm^Xm       
Md          , Md          , Md          , Md          , Md          , Hd          , Dd          , Dd          , Dd          , Dd          , Rd          , Dd          , Dd          , Hd          , Hd          , Hd          , Dd          , Dd          , Dd          , Rd          , Rd          , Rd          , Dd          , Dd          , Dd          , Dd          , Dd          , Dd          , Dd          , Dd          , Dd          , Dd          , Dd          , Dd          , Dd          , Dd          , Hd          , Dd          , Rd          , Rd          , Rd          , Gs          , Gs          , Mm          , Mm^Xm       , Mm^Xm       
Md^Xm       , Md^Xm       , Md^Xm       , Md          , Md          , Hd          , Hd          , Dd          , Dd          , Dd          , Rd          , Dd          , Hd          , Hd          , Re          , Re          , Dd          , Dd          , Dd          , Rd          , Rd          , Dd          , Dd          , Dd          , Rd          , Dd          , Rd          , Dd          , Dd          , Dd^Dr       , Rd          , Dd          , Dd^Dc       , Dd          , Dd          , Dd          , Rd          , Rd          , Rd          , Rd          , Rd          , Gs          , Mm          , Mm          , Mm^Xm       , Mm^Xm       
Md^Xm       , Md^Xm       , Md^Xm       , Md          , Md          , Md          , Hd          , Hd          , Hd          , Dd          , Rd          , Hd          , Hd          , Hd          , Re          , Re          , Dd          , Dd          , Dd          , Rd          , Rd          , Dd          , Rd          , Rd          , Dd          , Rd          , Dd          , Rd          , Rd          , Rd          , Rd          , Rd          , Rd          , Dd          , Rd          , Rd          , Dd          , Dd          , Dd          , Dd          , Dd          , Gs          , Gs          , Mm          , Mm^Xm       , Mm^Xm       
Md^Xm       , Md^Xm       , Md^Xm       , Md^Xm       , Md^Xm       , Md          , Md          , Md          , Md          , Hd          , Hd          , Rd          , Hd          , Re          , Dd          , Dd          , Dd          , Dd          , Dd          , Rd          , Rd          , Dd          , Rd          , Dd          , Dd          , Dd          , Dd          , Dd          , Dd          , Dd          , Dd          , Dd          , Dd          , Rd          , Dd          , Dd          , Dd          , Dd          , Dd          , Dd          , Dd          , Dd          , Gs          , Mm          , Mm          , Mm^Xm       
Md^Xm       , Md^Xm       , Md^Xm       , Md^Xm       , Md^Xm       , Md^Xm       , Md          , Md          , Md          , Hd          , Dd          , Rd          , Dd          , Dd          , Dd          , Dd          , Dd          , Dd          , Dd          , Rd          , Rd          , Rd          , Dd          , Dd          , Dd          , Dd          , Dd          , Dd          , Dd          , Dd          , Dd^Vda      , Dd          , Dd          , Rd          , Dd          , Dd          , Dd          , Dd          , Dd          , Dd          , Dd          , Dd          , Gs          , Hh^Vhh      , Mm          , Mm^Xm       
Md^Xm       , Md^Xm       , Md^Xm       , Md^Xm       , Md^Xm       , Md^Xm       , Md          , Md          , Hd          , Hd          , Dd          , Rd          , Rd          , Dd          , Dd          , Dd          , Dd          , Dd          , Rd          , Dd^Vda      , Rd          , Rd          , Rd          , Dd          , Dd          , Dd          , Rd          , Dd          , Rd          , Rd          , Rd          , Rd          , Rd          , Rd          , Dd          , Dd          , Dd          , Dd          , Dd          , Dd          , Dd          , Dd          , Gs          , Hh          , Mm          , Mm^Xm       
Md^Xm       , Md^Xm       , Md^Xm       , Md^Xm       , Md^Xm       , Md^Xm       , Md          , Md          , Hd          , Dd          , Dd          , Dd          , Rd          , Dd          , Rd          , Rd          , Rd          , Rd          , Dd          , Dd          , Dd          , Rd          , Rd          , Rd          , Rd          , Rd          , Rd          , Rd          , Rd          , Rd          , Dd          , Rd          , Rd          , Rd          , Rd          , Dd          , Dd^Vda      , Dd          , Dd          , Dd          , Dd          , Dd          , Gs          , Gs          , Hh          , Mm          
Md^Xm       , Md^Xm       , Md^Xm       , Md^Xm       , Md^Xm       , Md^Xm       , Md          , Md          , Md          , Hd          , Dd          , Dd          , Rd          , Rd          , Dd          , Dd          , Dd          , Dd          , Dd          , Dd          , Dd          , Dd          , Dd          , Rd          , Dd^Vda      , Rd          , Dd          , Rd          , Rd          , Dd          , Dd          , Dd          , Dd          , Rd          , Rd          , Rd          , Rd          , Dd          , Dd          , Dd          , Dd          , Dd          , Rd          , Gs          , Hh          , Mm          
Md          , Md^Xm       , Md          , Md          , Md          , Md          , Md          , Md          , Md          , Hd          , Rd          , Rd          , Dd          , Dd          , Dd          , Dd          , Dd          , Dd          , Dd          , Dd          , Dd          , Dd          , Dd          , Dd          , Dd          , Dd          , Dd          , Dd          , Dd          , Rd          , Rd          , Dd          , Rd          , Rd          , Dd          , Rd          , Rd          , Rd          , Rd          , Rd          , Rd          , Rd          , Rd          , Gs          , Gs          , Mm          
Md          , Md          , Md          , Md          , Rd          , Rd          , Rd          , Md          , Rd          , Rd          , Hd          , Dd          , Dd          , Dd          , Khr         , Dd          , Dd          , Dd          , Dd          , Dd          , Dd          , Dd          , Dd          , Dd          , Dd          , Dd          , Dd          , Dd          , Dd^Dc       , Dd          , Rd          , Dd^Vda      , Dd          , Dd          , Dd          , Dd          , Dd          , Rd          , Ce          , Ce          , Ce          , Rd          , Dd          , Gs          , Gs          , Gs          
Rd          , Rd          , Rd          , Rd          , Md          , Md          , Md          , Rd          , Md          , Md          , Hd          , Hd          , Dd          , Dd          , Dd          , Dd          , Dd          , Dd          , Dd          , Dd          , Dd          , Dd          , Dd          , Dd          , Dd          , Dd          , Dd          , Dd          , Rd          , Rd          , Dd          , Dd          , Dd          , Dd          , Dd          , Dd          , Dd          , Rd          , Ce          , 1 Ke        , Ce          , Rd          , Dd          , Dd          , Dd          , Gs          
Rd          , Rd          , Md          , Md          , Md          , Md          , Md^Xm       , Md          , Md          , Md          , Md          , Hd          , Dd          , Dd          , Dd          , Dd          , Dd          , Dd          , Dd          , Dd          , Dd          , Dd          , Dd          , Dd          , Dd          , Dd          , Dd          , Rd          , Dd          , Dd          , Dd          , Dd          , Dd          , Dd          , Dd          , Dd          , Dd          , Rd          , Rd          , Ce          , Rd          , Rd          , Dd          , Dd          , Dd          , Dd          
Md          , Md          , Md          , Md          , Md^Xm       , Md^Xm       , Md^Xm       , Md^Xm       , Md^Xm       , Md          , Md          , Hd          , Dd          , Dd          , Dd          , Dd          , Dd          , Dd          , Dd          , Dd          , Dd          , Re          , Dd          , Dd          , Dd          , Dd          , Rd          , Rd          , Dd          , Dd          , Dd          , Dd          , Dd          , Dd          , Dd          , Dd          , Dd          , Dd          , Dd          , Rd          , Dd^Vda      , Dd          , Dd          , Dd          , Dd          , Dd          
Md^Xm       , Md^Xm       , Md^Xm       , Md^Xm       , Md^Xm       , Md^Xm       , Md^Xm       , Md^Xm       , Md^Xm       , Md^Xm       , Md^Xm       , Hd          , Hd          , Dd          , Dd          , Dd          , Dd          , Dd          , Dd          , Dd          , Dd          , Dd          , Dd          , Dd          , Dd          , Dd          , Rd          , Dd          , Dd          , Dd          , Dd          , Dd          , Dd          , Dd          , Dd          , Dd          , Dd          , Dd          , Dd          , Dd          , Rd          , Dd          , Dd          , Dd          , Dd          , Dd          
Md^Xm       , Md^Xm       , Md^Xm       , Md^Xm       , Md^Xm       , Md^Xm       , Md^Xm       , Md^Xm       , Md^Xm       , Md^Xm       , Md^Xm       , Md          , Md          , Hd          , Hd          , Hd          , Hd          , Dd          , Ds          , Dd          , Dd          , Dd          , Dd          , Dd          , Rd          , Rd          , Dd          , Dd          , Dd          , Dd          , Dd          , Dd          , Dd          , Dd          , Dd          , Dd          , Dd          , Dd          , Dd          , Dd          , Dd          , Rd          , Rd          , Dd          , Re          , Dd          
