border_size=1
usage=map

Xv          , Xv          , Xv          , Xv          , Xv          , Xv          , Xv          , Xv          , Xv          , Xv          , Xv          , Xv          , Xv          , Xv          , Xv          , Xv          , Xv          , Xv          , Mm^Xm       , Mm^Xm       , Mm^Xm       , Mm^Xm       , Xu          , Xu          , Xu          , Xu          , Xu          , Xu          , Xu          , Xu          , Xu          , Hh          , Re          , Hh          
Xv          , Xv          , Xv          , Xv          , Xv          , Xv          , Xv          , Xv          , Xv          , Xv          , Xv          , Xv          , Xv          , Xv          , Xv          , Xv          , Mm^Xm       , Mm^Xm       , Mm^Xm       , Mm^Xm       , Xu          , Xu          , Ur          , Ur          , Uu^Vu       , Ur          , Ur          , Ur          , Uu          , Uu^Uf       , Xu          , Hh          , Re          , Hh          
Xv          , Xv          , Xv          , Xv          , Xv          , Xv          , Xv          , Xv          , Xv          , Xv          , Xv          , Xv          , Xv          , Xv          , Mm          , Hh^Fmw      , Hh          , Mm^Xm       , Hh          , Mm^Xm       , Xu          , Uu^Uf       , Uu^Vu       , Uu          , Ur          , Uu          , Ce          , Ce          , Ce          , Ur          , Ur          , Hh          , Re          , Hh          
Xv          , Xv          , Xv          , Xv          , Xv          , Xv          , Xv          , Xv          , Xv          , Xv          , Xv          , Xv          , Mm^Xm       , Mm^Xm       , Mm^Xm       , Hh^Fmw      , Gs^Fmw      , Mm^Xm       , Hh          , Hh          , Gg          , Ur          , Uu          , Ur          , Ur          , Uu          , Ce          , 2 Ke        , Ce          , Ur          , Re          , Re          , Gg          , Hh          
Xv          , Xv          , Xv          , Xv          , Xv          , Xv          , Xv          , Xv          , Xv          , Xv          , Mm^Xm       , Mm^Xm       , Mm^Xm       , Mm^Xm       , Hh          , Gs^Fmw      , Gs^Fmw      , Mm^Xm       , Gg^Efm         , Gg^Efm         , Gg          , Gg          , Xu          , Uu^Uf       , Ur          , Uu^Uf       , Ur          , Ce          , Xu          , Xu          , Re          , Gg          , Gg          , Hh^Fp       
Xv          , Xv          , Xv          , Xv          , Xv          , Xv          , Xv          , Xv          , Mm^Xm       , Mm^Xm       , Ww          , Hh          , Mm^Xm       , Mm^Xm       , Hh^Vhh      , Gs^Fmw      , Gs^Fmw      , Gs^Fmw      , Gg^Efm         , Gg^Efm         , Gs^Fp       , Gg          , Gs^Fp       , Xu          , Hh^Fp       , Xu          , Re          , Ur          , Gg          , Gg          , Re          , Gg          , Hh^Fp       , Hh^Fp       
Xv          , Xv          , Xv          , Xv          , Xv          , Xv          , Mm          , Mm          , Mm          , Ww          , Ww          , Gs^Fp       , Mm^Xm       , Mm          , Gs^Fmw      , Re          , Re          , Gg          , Gg          , Gs^Fp       , Gs^Fp       , Gs^Fp       , Gs^Fp       , Gs^Fp       , Gs^Fp       , Gs^Fp       , Gs^Fp       , Re          , Re          , Gg          , Re          , Gg          , Gg          , Hh^Fp       
Xv          , Xv          , Xv          , Xv          , Mm^Xm       , Mm          , Mm          , Mm          , Hh          , Hh          , Gs^Fp       , Gs^Fp       , Gg^Efm         , Mm          , Mm          , Gg          , Gg          , Re          , Re          , Gg          , Gs^Fp       , Gs^Fp       , Gs^Fp       , Gs^Fp       , Gs^Fp       , Gs^Fp       , Gs^Fp       , Gs^Fp       , Re          , Gg          , Re          , Gg          , Gg^Efm         , Mm^Xm       
Xv          , Xv          , Mm^Xm       , Mm^Xm       , Mm          , Gs^Fp       , Hh          , Hh          , Gs^Fp       , Hh          , Gg^Efm         , Gs^Fp       , Gg^Efm         , Gg          , Gg          , Gg          , Gg          , Re          , Hh          , Re          , Re          , Gg          , Gs^Fp       , Gs^Fp       , Re^Vct      , Gs^Fp       , Gs^Fp       , Gs^Fp       , Re          , Re          , Gg^Efm         , Gg^Efm         , Gg^Efm         , Mm^Xm       
Mm^Xm       , Mm^Xm       , Mm^Xm       , Mm^Xm       , Hh          , Gs^Fp       , Hh          , Hh          , Gg^Efm         , Gg^Efm         , Ss          , Gg^Efm         , Ss          , Gg^Efm         , Gg          , Gg          , Gg          , Re          , Mm          , Mm          , Mm^Vhh      , Re          , Gs^Fp       , Gs^Fp       , Gs^Fp       , Gs^Fp       , Gs^Fp       , Re          , Gg^Efm         , Re          , Gg^Efm         , Hh          , Gg^Efm         , Mm^Xm       
Mm^Xm       , Mm^Xm       , Mm^Xm       , Mm^Xm       , Hh          , Gs^Fp       , Gg          , Gg          , Ss          , Ss          , Gg          , Ss          , Ss          , Ss          , Gs^Fmw      , Gs^Fmw      , Gs^Fmw      , Re          , Mm^Xm       , Mm^Xm       , Mm          , Re          , Gs^Fp       , Gs^Fp       , Gs^Fp       , Gs^Fp       , Re          , Re          , Gg^Efm         , Re          , Gg^Efm         , Hh          , Gg^Efm         , Mm^Xm       
Mm^Xm       , Mm^Xm       , Mm^Xm       , Mm^Xm       , Gg          , Gg          , Ss          , Ss          , Gg          , Ss          , Gs^Vht      , Gg          , Ss          , Gs^Fmw      , Gs^Fmw      , Gs^Fmw      , Gg          , Re          , Mm          , Mm^Xm       , Mm          , Re          , Gs^Fp       , Gs^Fp       , Gs^Fp       , Re          , Gg^Efm         , Gg^Efm         , Gg^Efm         , Re          , Gg^Vc       , Gg^Efm         , Hh          , Mm^Xm       
Mm^Xm       , Mm^Xm       , Gs^Fp       , Gs^Fp       , Gs^Fp       , Gg          , Gg          , Ss^Vm       , Gg          , Ss          , Ss          , Ss          , Gg          , Gs^Fmw      , Gs^Fmw      , Gs^Fmw      , Gg          , Re          , Mm          , Mm^Xm       , Mm          , Re          , Gs^Fp       , Gs^Fp       , Gs^Fp       , Re          , Gg^Efm         , Hh          , Hh          , Re          , Gg^Efm         , Gg^Efm         , Hh          , Mm          
Mm^Xm       , Mm^Xm       , Mm^Xm       , Hh^Fp       , Gs^Fp       , Ss          , Gg          , Ss          , Ss          , Ss          , Gg          , Ss          , Gg          , Gs^Fmw      , Gg          , Gs^Fmw      , Gg          , Re          , Hh          , Mm^Xm       , Hh          , Re          , Re          , Re          , Re          , Re          , Gs^Fp       , Gg^Efm         , Gg          , Re          , Gs^Fp       , Hh          , Mm          , Mm          
Mm^Xm       , Mm^Xm       , Gs^Fp       , Gs^Fp       , Gg          , Gg          , Ss          , Gg          , Gg          , Gg          , Ss          , Gg          , Gg          , Gg          , Re          , Gg          , Re          , Re          , Mm          , Mm          , Hh          , Hh^Fmw      , Mm          , Hh^Fp       , Gs^Fp       , Gs^Fp       , Gs^Fmw      , Gs^Fp       , Gs^Fp       , Re          , Gs^Fp       , Gs^Fp       , Mm          , Mm          
Mm^Xm       , Mm^Xm       , Mm^Xm       , Mm^Xm       , Mm          , Gg          , Ss          , Gg          , Gg          , Gg          , Gg          , Gg          , Re          , Re          , Gs^Fp       , Re          , Mm          , Hh          , Mm^Xm       , Mm^Xm       , Hh          , Hh^Vhh      , Mm          , Hh^Fp       , Gs^Fp       , Gs^Fmw      , Gs^Fmw      , Gs^Fmw      , Gs^Fmw      , Re          , Gs^Fp       , Gs^Fp       , Mm          , Mm          
Mm^Xm       , Mm^Xm       , Mm^Xm       , Mm^Xm       , Hh          , Gg          , Gg          , Gg          , Re          , Re          , Re          , Re          , Gg          , Gg^Vh       , Gs^Fp       , Gs^Fp       , Mm^Xm       , Mm          , Hh^Fmw      , Hh          , Hh^Fdf      , Hh          , Mm          , Hh^Fp       , Hh^Fp       , Gs^Fp       , Gs^Fp       , Gs^Fmw      , Gs^Fp       , Re          , Hh^Fp       , Hh^Fp       , Gs^Fp       , Mm          
Mm^Xm       , Mm^Xm       , Mm^Xm       , Mm^Xm       , Mm          , Gg          , Re          , Re          , Gg          , Gs^Fp       , Gs^Fp       , Gg          , Gg          , Gs^Fp       , Gs^Fp       , Gs^Fp       , Mm^Xm       , Hh          , Hh^Fdf      , Hh          , Mm          , Mm          , Mm^Xm       , Mm^Xm       , Hh^Fp       , Gs^Fp       , Hh^Fp       , Hh^Fp       , Wwf         , Re          , Gg^Vc       , Gs^Fp       , Hh^Fp       , Hh^Fp       
Mm^Xm       , Mm^Xm       , Mm^Xm       , Mm^Xm       , Hh          , Re          , Gs^Fp       , Gg          , Mm          , Hh          , Mm          , Hh          , Mm          , Gs^Fp       , Mm          , Gs^Fp       , Hh^Fmw      , Mm^Xm       , Mm^Xm       , Mm^Xm       , Mm^Xm       , Ww          , Ww          , Mm^Xm       , Mm          , Gs^Fp       , Ww          , Ww          , Ww          , Wwf         , Ww          , Gg          , Hh^Fp       , Hh^Fp       
Mm^Xm       , Mm^Xm       , Mm^Xm       , Mm^Xm       , Hh          , Rd          , Gs^Fp       , Gs^Fp       , Hh^Vc       , Hh^Fmw      , Gg          , Gs^Fp       , Mm          , Mm          , Gs^Fp       , Hh^Fmw      , Gs^Fp       , Gs^Fp       , Gg          , Gs^Fp       , Hh^Fmw      , Gs^Fp       , Hh^Fp       , Ww          , Ww          , Ww          , Gg^Efm         , Gg^Efm         , Gg^Efm         , Gg^Efm         , Gg^Efm         , Ww          , Ww          , Hh^Fp       
Mm^Xm       , Mm^Xm       , Mm^Xm       , Mm^Xm       , Mm          , Rd          , Re          , Re          , Re          , Re          , Re          , Gg          , Gg          , Mm          , Gs^Fp       , Mm          , Gg          , Gg          , Hh^Fmw      , Hh^Fp       , Re          , Hh^Fmw      , Gg          , Gg          , Gg          , Ww          , Gg^Efm         , Gg^Efm         , Gg^Fet      , Gg^Efm         , Gg^Efm         , Ww          , Ww          , Hh^Fp       
Mm^Xm       , Mm^Xm       , Mm^Xm       , Mm^Xm       , Mm          , Rd          , Gg          , Gg          , Gg          , Gg          , Gg          , Re          , Re          , Gg          , Re          , Gg          , Hh^Fmw      , Hh^Vhh      , Re          , Re          , Gg          , Re          , Re          , Gg          , Ww^Bw/      , Ww^Bw/      , Gg^Efm         , Gg^Efm         , Gg^Efm         , Gg^Efm         , Gg^Efm         , Ww          , Ww          , Hh^Fp       
Mm^Xm       , Mm^Xm       , Mm^Xm       , Mm^Xm       , Hh          , Rd          , Ce          , Ce          , Ce          , Gg          , Gs^Fp       , Re^Vct      , Gs^Fp       , Re          , Gg          , Re          , Re          , Re          , Gg          , Hh          , Hh          , Gg          , Hh          , Re          , Gg          , Ww          , Ww          , Gg^Efm         , Ww          , Gg^Efm         , Ww          , Ww          , Gg          , Hh^Fp       
Mm^Xm       , Mm^Xm       , Mm^Xm       , Hh          , Rd          , Rd          , Ce          , 1 Ke        , Ce          , Gs^Fp       , Gs^Fp       , Gs^Fp       , Gs^Fp       , Gs^Fp       , Gs^Fp       , Gs^Fp       , Gg          , Gs^Fp       , Hh          , Hh          , Hh          , Hh          , Hh          , Hh          , Mm^Vhh      , Gg          , Gg          , Ww          , Ww          , Ww          , Gg          , Gg          , Hh          , Hh          
Mm^Xm       , Mm^Xm       , Mm^Xm       , Rd          , Hh          , Hh          , Hh          , Ce          , Gg          , Gs^Fp       , Gs^Fp       , Gs^Fp       , Gs^Fp       , Gs^Fp       , Mm          , Mm          , Mm          , Hh          , Mm          , Mm          , Mm          , Mm          , Mm          , Mm          , Mm          , Hh          , Gg          , Gg          , Ww          , Ww          , Gg          , Hh          , Hh          , Hh^Fp       
Mm^Xm       , Mm^Xm       , Rd          , Rd          , Mm^Xm       , Mm^Xm       , Mm^Xm       , Mm^Xm       , Mm^Xm       , Mm^Xm       , Mm^Xm       , Mm^Xm       , Mm^Xm       , Mm^Xm       , Mm^Xm       , Mm^Xm       , Mm^Xm       , Mm^Xm       , Mm^Xm       , Mm^Xm       , Mm^Xm       , Mm^Xm       , Mm^Xm       , Mm          , Mm          , Mm          , Wwf         , Ww          , Ww          , Gg          , Gg          , Hh          , Hh          , Hh          
