border_size=1
usage=map

Mm^Xm       , Mm^Xm       , Mm^Xm       , Mm^Xm       , Mm^Xm       , Mm^Xm       , Mm^Xm       , Mm^Xm       , Mm^Xm       , Mm^Xm       , Mm^Xm       , Mm^Xm       , Mm^Xm       , Mm^Xm       , Mm^Xm       , Mm^Xm       , Mm          , Mm          , Mm          , Qxu         , Qxu         , Qxu         , Qxu         , Qxu         , Qxu         , Qxu         , Qxu         , Qxu         , Qxu         , Qxu         , Qxu         , Qxu         
Mm^Xm       , Mm^Xm       , Mm^Xm       , Mm^Xm       , Mm^Xm       , Mm^Xm       , Mm^Xm       , Mm^Xm       , Mm^Xm       , Mm^Xm       , Mm^Xm       , Mm^Xm       , Mm          , Mm^Xm       , Mm          , Mm          , Gs^Fdw      , Gs^Fdw      , Gs^Fmw      , Gg          , Gg          , Qxu         , Gg          , Qxu         , Qxu         , Qxu         , Qxu         , Qxu         , Qxu         , Qxu         , Qxu         , Qxu         
Mm^Xm       , Mm^Xm       , Mm^Xm       , Mm^Xm       , Mm^Xm       , Mm^Xm       , Mm^Xm       , Mm^Xm       , Mm          , Mm          , Mm          , Mm          , Gs^Fdw      , Mm          , Gs^Fdw      , Gs^Fdw      , Gs^Fdw      , Gs^Fdw      , Gg          , Gg          , Gg          , Gg          , Gg          , Qxu         , Qxu         , Qxu         , Qxu         , Qxu         , Qxu         , Qxu         , Qxu         , Qxu         
Mm^Xm       , Mm          , Mm^Xm       , Mm^Xm       , Mm          , Mm          , Gs^Fmw      , Mm          , Gs^Fdw      , Gs^Fdw      , Gs^Fdw      , Gs^Fdw      , Gs^Fdw      , Gs^Fdw      , Gg          , Gs^Fmw      , Gg          , Gg          , Gg          , Gg          , Cud         , Cud         , Cud         , Gg          , Gg          , Gg          , Gg          , Qxu         , Qxu         , Qxu         , Qxu         , Qxu         
Mm^Xm       , Mm^Xm       , Mm^Xm       , Mm          , Gs^Fdw      , Gs^Fdw      , Gs^Fdw      , Gs^Fdw      , Gg          , Gs^Fmw      , Gg          , Gs^Fmw      , Gg          , Gg          , Gg          , Gg          , Gg          , Gg          , Cud         , Cud         , Ur          , Ur          , Ur          , Cud         , Cud         , Gg          , Gg          , Qxu         , Qxu         , Qxu         , Qxu         , Qxu         
Mm^Xm       , Mm^Xm       , Mm          , Mm          , Gs^Fdw      , Gs^Fmw      , Gg          , Gg          , Gg          , Gg          , Gg          , Gg          , Gg          , Gg          , Gg          , Gg          , Cud         , Cud         , Ur          , Ur          , Ur          , Ur          , Ur          , Ur          , Ur          , Cud         , Cud         , Gg          , Gg          , Qxu         , Qxu         , Qxu         
Mm          , Mm          , Gs^Fdw      , Gs^Fdw      , Gg          , Gg          , Re          , Gg          , Re          , Gg          , Re          , Gg          , Re          , Re          , Re          , Cud         , Ur          , Ur          , Ur          , Ur          , Ur          , Ur          , Ur          , Ur          , Ur          , Ur          , Ur          , Cud         , Gg          , Qxu         , Qxu         , Qxu         
Gs^Fdw      , Gs^Fdw      , Re^Cov      , Re^Cov      , Re          , Re          , Re          , Re          , Re          , Re          , Re          , Re          , Re          , Re          , Re          , Cud         , Ur          , Ur          , Ur          , Ur          , Ur          , Ur          , Ur          , Ur          , Ch          , Ur          , Ur          , Cud         , Gg          , Gg          , Qxu         , Qxu         
Re          , Re^Cov      , Re^Cov      , Re^Cov      , Re          , Re          , Re          , Re          , Re          , Re          , Re          , Re          , Re          , Re          , Re          , Cud         , Ur          , Ur          , Ur          , Ur          , Ur          , Ur          , Ch          , Ch          , Ur          , Ur          , Ur          , Cud         , Gg          , Gg          , Qxu         , Qxu         
Re          , Re^Cov      , 3 Re^Kov    , Re^Cov      , Re          , Re          , Re          , Re          , Re          , Re          , Re          , Re          , Re          , Re          , Re          , Ur          , Ur          , Ur          , Ur          , Ur          , Ur          , Ur          , Ch          , Ur          , 1 Kh        , Ur          , Ur          , Cud         , Gg          , Qxu         , Qxu         , Qxu         
Re          , Re^Cov      , Re^Cov      , Re^Cov      , Re          , Re          , Re          , Re          , Re          , Re          , Re          , Re          , Re          , Re          , Re          , Ur          , Ur          , Ur          , Ur          , Ur          , Ur          , Ur          , Ch          , Ur          , Ur          , Ur          , Ur          , Cud         , Gg          , Qxu         , Qxu         , Qxu         
Gs^Fdw      , Re^Cov      , Re^Cov      , Re^Cov      , Re          , Re          , Re          , Re          , Re          , Re          , Re          , Re          , Re          , Re          , Re          , Cud         , Ur          , Ur          , Ur          , Ur          , Ur          , Ur          , Ur          , Ch          , Ch          , Ur          , Ur          , Cud         , Gg          , Gg          , Qxu         , Qxu         
Mm          , Gs^Fdw      , Gs^Fmw      , Re^Cov      , Gg          , Re          , Re          , Re          , Re          , Re          , Re          , Re          , Re          , Re          , Re          , Cud         , Ur          , Ur          , Ur          , Ur          , Ur          , Ur          , Ur          , Ur          , Ur          , Ur          , Ur          , Cud         , Gg          , Gg          , Qxu         , Qxu         
Mm^Xm       , Mm          , Mm          , Gs^Fdw      , Gs^Fdw      , Gg          , Gg          , Gg          , Gg          , Gg          , Gg          , Gg          , Gg          , Re          , Gg          , Cud         , Cud         , Ur          , Ur          , Ur          , Ur          , Ur          , Ur          , Ur          , Ur          , Ur          , Cud         , Cud         , Gg          , Qxu         , Qxu         , Qxu         
Mm^Xm       , Mm^Xm       , Mm          , Gs^Fdw      , Gs^Fdw      , Gs^Fdw      , Gs^Fdw      , Gg          , Gg          , Gg          , Gg          , Gg          , Gg          , Gg          , Gg          , Gg          , Gg          , Cud         , Cud         , Ur          , Ur          , Ur          , Ur          , Ur          , Cud         , Cud         , Gg          , Gg          , Gg          , Gg          , Qxu         , Qxu         
Mm^Xm       , Mm^Xm       , Mm^Xm       , Mm          , Mm          , Gs^Fmw      , Gs^Fdw      , Gs^Fdw      , Gs^Fdw      , Gs^Fdw      , Gs^Fdw      , Gs^Fmw      , Gs^Fdw      , Gg          , Gg          , Gg          , Gg          , Gg          , Gg          , Cud         , Cud         , Ur          , Cud         , Cud         , Gg          , Gg          , Qxu         , Gg          , Qxu         , Qxu         , Qxu         , Qxu         
Mm^Xm       , Mm^Xm       , Mm^Xm       , Mm^Xm       , Mm^Xm       , Mm          , Mm          , Mm          , Mm          , Gs^Fmw      , Mm          , Gs^Fdw      , Mm          , Hh^Fdw      , Gs^Fdw      , Gs^Fdw      , Gs^Fdw      , Gg          , Gg          , Gg          , Gg          , Cud         , Gg          , Gg          , Qxu         , Gg          , Qxu         , Qxu         , Qxu         , Qxu         , Qxu         , Qxu         
Mm^Xm       , Mm^Xm       , Mm^Xm       , Mm^Xm       , Mm^Xm       , Mm^Xm       , Mm^Xm       , Mm^Xm       , Mm^Xm       , Mm          , Mm^Xm       , Mm          , Mm^Xm       , Mm          , Mm          , Gs^Fmw      , Gs^Fdw      , Gs^Fdw      , Gs^Fmw      , Gg          , Gg          , Gg          , Gg          , Qxu         , Qxu         , Qxu         , Qxu         , Qxu         , Qxu         , Qxu         , Qxu         , Qxu         
Mm^Xm       , Mm^Xm       , Mm^Xm       , Mm^Xm       , Mm^Xm       , Mm^Xm       , Mm^Xm       , Mm^Xm       , Mm^Xm       , Mm^Xm       , Mm^Xm       , Mm^Xm       , Mm^Xm       , Mm^Xm       , Mm^Xm       , Mm          , Mm          , Mm          , Mm          , Mm          , Qxu         , Qxu         , Qxu         , Qxu         , Qxu         , Qxu         , Qxu         , Qxu         , Qxu         , Qxu         , Qxu         , Qxu         
